{
  "PlayerStarterPosition": {
    "X": 1,
    "Y": 1
  },
  "PlayerStarterAngle": 0,
  "DistanceShade": 1,
  "MapCeiling": [
    [3,3,3,3,3,3,3,3,3,3,3],
    [3,3,3,3,3,3,3,3,3,3,3],
    [3,3,3,3,3,3,3,3,3,3,3],
    [3,3,3,3,3,3,3,3,3,3,3],
    [3,3,3,3,3,3,3,3,3,3,3],
    [3,3,3,3,3,3,3,3,3,3,3],
    [3,3,3,3,3,3,3,3,3,3,3],
    [3,3,3,3,3,3,3,3,3,3,3],
    [3,3,3,3,3,3,3,3,3,3,3],
    [3,3,3,3,3,3,3,3,3,3,3],
    [3,3,3,3,3,3,3,3,3,3,3]
  ],
  "MapWalls": [
    [1,1,1,1,1,4,1,1,1,1,1],
    [1,0,0,0,1,0,0,0,0,0,1],
    [1,0,1,0,1,0,1,1,1,0,1],
    [1,0,1,0,0,0,1,0,0,0,1],
    [1,0,1,1,1,0,1,0,1,0,1],
    [4,0,0,0,1,0,0,0,1,0,4],
    [1,1,1,0,1,1,1,0,1,0,1],
    [1,0,0,0,0,0,1,0,0,0,1],
    [1,0,1,1,1,0,1,1,1,0,1],
    [1,0,0,0,0,0,0,0,0,0,1],
    [1,1,1,1,1,4,1,1,1,1,1]
  ],
  "MapFloor": [
    [2,2,2,2,2,2,2,2,2,2,2],
    [2,2,2,2,2,2,2,2,2,2,2],
    [2,2,2,2,2,2,2,2,2,2,2],
    [2,2,2,2,2,2,2,2,2,2,2],
    [2,2,2,2,2,2,2,2,2,2,2],
    [2,2,2,2,2,2,2,2,2,2,2],
    [2,2,2,2,2,2,2,2,2,2,2],
    [2,2,2,2,2,2,2,2,2,2,2],
    [2,2,2,2,2,2,2,2,2,2,2],
    [2,2,2,2,2,2,2,2,2,2,2],
    [2,2,2,2,2,2,2,2,2,2,2]
  ],
  "Sprites": [
    { "Type": 0, "Id": 0, "Position": { "X": 2, "Y": 1 } },
    { "Type": 0, "Id": 0, "Position": { "X": 8, "Y": 9 } },
    { "Type": 2, "Id": 0, "Position": { "X": 5, "Y": 3 } },
    { "Type": 2, "Id": 0, "Position": { "X": 3, "Y": 7 } },
    { "Type": 2, "Id": 1, "Position": { "X": 7, "Y": 7 } }
  ]
}
