{
  "PlayerStarterPosition": {
    "X": 5,
    "Y": 8
  },
  "PlayerStarterAngle": 180,
  "DistanceShade": 1,
  "MapCeiling": [
    [3,3,3,3,3,3,3,3,3,3,3],
    [3,3,3,3,3,3,3,3,3,3,3],
    [3,3,3,3,3,3,3,3,3,3,3],
    [3,3,3,3,3,3,3,3,3,3,3],
    [3,3,3,3,3,3,3,3,3,3,3],
    [3,3,3,3,3,3,3,3,3,3,3],
    [3,3,3,3,3,3,3,3,3,3,3],
    [3,3,3,3,3,3,3,3,3,3,3],
    [3,3,3,3,3,3,3,3,3,3,3],
    [3,3,3,3,3,3,3,3,3,3,3],
    [3,3,3,3,3,3,3,3,3,3,3]
  ],
  "MapWalls": [
    [1,1,1,1,1,4,1,1,1,1,1],
    [1,0,0,0,0,0,0,0,0,0,1],
    [1,0,1,0,1,0,1,0,1,0,1],
    [1,0,0,0,0,0,0,0,0,0,1],
    [1,0,1,0,2,0,2,0,1,0,1],
    [4,0,0,0,0,0,0,0,0,0,4],
    [1,0,1,0,2,0,2,0,1,0,1],
    [1,0,0,0,0,0,0,0,0,0,1],
    [1,0,1,0,1,0,1,0,1,0,1],
    [1,0,0,0,0,0,0,0,0,0,1],
    [1,1,1,1,1,4,1,1,1,1,1]
  ],
  "MapFloor": [
    [2,2,2,2,2,2,2,2,2,2,2],
    [2,2,2,2,2,2,2,2,2,2,2],
    [2,2,2,2,2,2,2,2,2,2,2],
    [2,2,2,2,2,2,2,2,2,2,2],
    [2,2,2,2,2,2,2,2,2,2,2],
    [2,2,2,2,2,2,2,2,2,2,2],
    [2,2,2,2,2,2,2,2,2,2,2],
    [2,2,2,2,2,2,2,2,2,2,2],
    [2,2,2,2,2,2,2,2,2,2,2],
    [2,2,2,2,2,2,2,2,2,2,2],
    [2,2,2,2,2,2,2,2,2,2,2]
  ],
  "Sprites": [
    { "Type": 0, "Id": 0, "Position": { "X": 1, "Y": 1 } },
    { "Type": 0, "Id": 0, "Position": { "X": 9, "Y": 1 } },
    { "Type": 0, "Id": 0, "Position": { "X": 1, "Y": 9 } },
    { "Type": 0, "Id": 0, "Position": { "X": 9, "Y": 9 } },
    { "Type": 2, "Id": 0, "Position": { "X": 5, "Y": 2 } },
    { "Type": 2, "Id": 0, "Position": { "X": 3, "Y": 5 } },
    { "Type": 2, "Id": 1, "Position": { "X": 7, "Y": 5 } },
    { "Type": 2, "Id": 1, "Position": { "X": 5, "Y": 7 } }
  ]
}
