{
  "PlayerStarterPosition": {
    "X": 5,
    "Y": 5
  },
  "PlayerStarterAngle": 0,
  "DistanceShade": 1,
  "MapCeiling": [
    [ 3, 3, 3, 3, 3, 3, 3, 3, 3, 3, 3 ],
    [ 3, 3, 3, 3, 3, 3, 3, 3, 3, 3, 3 ],
    [ 3, 3, 3, 3, 3, 3, 3, 3, 3, 3, 3 ],
    [ 3, 3, 3, 3, 3, 3, 3, 3, 3, 3, 3 ],
    [ 3, 3, 3, 3, 3, 3, 3, 3, 3, 3, 3 ],
    [ 3, 3, 3, 3, 3, 3, 3, 3, 3, 3, 3 ],
    [ 3, 3, 3, 3, 3, 3, 3, 3, 3, 3, 3 ],
    [ 3, 3, 3, 3, 3, 3, 3, 3, 3, 3, 3 ],
    [ 3, 3, 3, 3, 3, 3, 3, 3, 3, 3, 3 ],
    [ 3, 3, 3, 3, 3, 3, 3, 3, 3, 3, 3 ],
    [ 3, 3, 3, 3, 3, 3, 3, 3, 3, 3, 3 ]
  ],
  "MapWalls": [
    [ 1, 1, 1, 1, 1, 4, 1, 1, 1, 1, 1 ],
    [ 1, 0, 0, 0, 0, 0, 0, 0, 0, 0, 1 ],
    [ 1, 0, 0, 0, 0, 0, 0, 0, 0, 0, 1 ],
    [ 1, 0, 0, 0, 0, 0, 0, 0, 0, 0, 1 ],
    [ 1, 0, 0, 0, 0, 0, 0, 0, 0, 0, 1 ],
    [ 4, 0, 0, 0, 0, 0, 0, 0, 0, 0, 4 ],
    [ 1, 0, 0, 0, 0, 0, 0, 0, 0, 0, 1 ],
    [ 1, 0, 0, 0, 0, 0, 0, 0, 0, 0, 1 ],
    [ 1, 0, 1, 2, 3, 4, 5, 0, 0, 0, 1 ],
    [ 1, 0, 0, 0, 0, 0, 0, 0, 0, 0, 1 ],
    [ 1, 1, 1, 1, 1, 4, 1, 1, 1, 1, 1 ]
  ],
  "MapFloor": [
    [ 2, 2, 2, 2, 2, 2, 2, 2, 2, 2, 2 ],
    [ 2, 2, 2, 2, 2, 2, 2, 2, 2, 2, 2 ],
    [ 2, 2, 2, 2, 2, 2, 2, 2, 2, 2, 2 ],
    [ 2, 2, 2, 2, 2, 2, 2, 2, 2, 2, 2 ],
    [ 2, 2, 2, 2, 2, 2, 2, 2, 2, 2, 2 ],
    [ 2, 2, 2, 2, 2, 2, 2, 2, 2, 2, 2 ],
    [ 2, 2, 2, 2, 2, 2, 2, 2, 2, 2, 2 ],
    [ 2, 2, 2, 2, 2, 2, 2, 2, 2, 2, 2 ],
    [ 2, 2, 2, 2, 2, 2, 2, 2, 2, 2, 2 ],
    [ 2, 2, 2, 2, 2, 2, 2, 2, 2, 2, 2 ],
    [ 2, 2, 2, 2, 2, 2, 2, 2, 2, 2, 2 ]
  ],
  "Sprites": [
    {
      "Type": 0,
      "Id": 0,
      "Position": {
        "X": 1,
        "Y": 1
      }
    },
    {
      "Type": 0,
      "Id": 0,
      "Position": {
        "X": 1,
        "Y": 9
      }
    },
    {
      "Type": 0,
      "Id": 0,
      "Position": {
        "X": 9,
        "Y": 1
      }
    },
    {
      "Type": 0,
      "Id": 0,
      "Position": {
        "X": 9,
        "Y": 9
      }
    }
  ]
}