{
  "PlayerStarterPosition": {
    "X": 5,
    "Y": 1
  },
  "PlayerStarterAngle": 300,
  "DistanceShade":  10,
  "MapCeiling": [
    [ 2, 2, 2, 2, 2, 2, 2 ],
    [ 2, 2, 2, 2, 2, 2, 2 ],
    [ 2, 2, 2, 0, 2, 2, 2 ],
    [ 2, 2, 2, 2, 2, 2, 2 ],
    [ 2, 2, 2, 0, 2, 2, 2 ],
    [ 2, 2, 2, 2, 2, 2, 2 ],
    [ 2, 2, 2, 2, 2, 2, 2 ]
  ],
  "MapWalls": [
    [ 1, 1, 1, 1, 1, 1, 2 ],
    [ 4, 0, 0, 0, 0, 0, 2 ],
    [ 4, 0, 0, 0, 0, 0, 2 ],
    [ 4, 0, 0, 0, 0, 0, 2 ],
    [ 4, 0, 0, 0, 0, 0, 2 ],
    [ 4, 0, 0, 0, 0, 0, 2 ],
    [ 4, 3, 3, 3, 3, 3, 3 ]
  ],
  "MapFloor": [
    [ 4, 4, 4, 4, 4, 4, 4 ],
    [ 4, 4, 4, 4, 4, 4, 4 ],
    [ 4, 4, 4, 4, 4, 4, 4 ],
    [ 4, 4, 4, 4, 4, 4, 4 ],
    [ 4, 4, 4, 4, 4, 4, 4 ],
    [ 4, 4, 4, 4, 4, 4, 4 ],
    [ 4, 4, 4, 4, 4, 4, 4 ]
  ],
  "Sprites": [
    {
      "Type": 0,
      "Id": 4,
      "Position": {
        "X": 1,
        "Y": 1
      }
    },
    {
      "Type": 1,
      "Id": 3,
      "Position": {
        "X": 2,
        "Y": 1
      }
    },
    {
      "Type": 2,
      "Id": 1,
      "Position": {
        "X": 3,
        "Y": 1
      }
    }
  ]
}