{
  "RoomWalls": [
    [ 1, 1, 1, 0, 1, 1, 1 ],
    [ 1, 0, 0, 0, 0, 0, 1 ],
    [ 1, 0, 0, 0, 0, 0, 1 ],
    [ 0, 0, 0, 0, 0, 0, 0 ],
    [ 1, 0, 0, 0, 0, 0, 1 ],
    [ 1, 0, 0, 0, 0, 0, 1 ],
    [ 1, 1, 1, 0, 1, 1, 1 ]
  ],
  "Sprites": [
    { "Type": 0, "Id": 6, "Position": { "X": 3, "Y": 3 } }
  ]
}
