{
  "RoomWalls": [
    [ 1, 1, 1, 0, 1, 1, 1 ],
    [ 1, 0, 0, 0, 0, 0, 1 ],
    [ 1, 0, 0, 1, 0, 0, 1 ],
    [ 0, 0, 1, 0, 1, 0, 0 ],
    [ 1, 0, 0, 1, 0, 0, 1 ],
    [ 1, 0, 0, 0, 0, 0, 1 ],
    [ 1, 1, 1, 0, 1, 1, 1 ]
  ],
  "Sprites": [
    { "Type": 2, "Id": 0, "Position": { "X": 2, "Y": 2 } },
    { "Type": 1, "Id": 0, "Position": { "X": 4, "Y": 4 } }
  ]
}
