{
  "RoomWalls": [
    [ 1, 1, 1, 0, 1, 1, 1 ],
    [ 1, 0, 1, 0, 1, 0, 1 ],
    [ 1, 0, 0, 0, 0, 0, 1 ],
    [ 0, 0, 0, 1, 0, 0, 0 ],
    [ 1, 0, 0, 0, 0, 0, 1 ],
    [ 1, 0, 1, 0, 1, 0, 1 ],
    [ 1, 1, 1, 0, 1, 1, 1 ]
  ],
  "Sprites": [
    { "Type": 2, "Id": 1, "Position": { "X": 4, "Y": 2 } },
    { "Type": 0, "Id": 3, "Position": { "X": 2, "Y": 4 } }
  ]
}
