{
  "PlayerStarterPosition": {
    "X": 3,
    "Y": 2
  },
  "PlayerStarterAngle": 60,
  "MapCeiling": [
    [ 2, 2, 2, 2, 2, 2, 2, 2, 2, 2 ],
    [ 2, 2, 2, 2, 2, 2, 2, 2, 2, 2 ],
    [ 2, 2, 3, 2, 2, 2, 2, 2, 2, 2 ],
    [ 2, 2, 2, 2, 2, 2, 2, 2, 2, 2 ],
    [ 2, 2, 2, 2, 2, 2, 2, 2, 2, 2 ],
    [ 2, 2, 2, 2, 2, 2, 2, 2, 2, 2 ],
    [ 2, 2, 2, 2, 2, 2, 2, 2, 2, 2 ],
    [ 2, 2, 2, 2, 2, 2, 6, 0, 2, 2 ],
    [ 2, 2, 2, 2, 2, 2, 2, 2, 2, 2 ],
    [ 2, 2, 2, 2, 2, 2, 2, 2, 2, 2 ]
  ],
  "MapWalls": [
    [ 1, 1, 1, 1, 1, 2, 2, 2, 2, 2 ],
    [ 8, 0, 0, 0, 0, 0, 0, 0, 0, 3 ],
    [ 8, 0, 0, 0, 0, 0, 0, 0, 0, 3 ],
    [ 8, 0, 0, 9, 0, 0, 0, 0, 0, 3 ],
    [ 8, 0, 0, 0, 0, 0, 0, 0, 0, 3 ],
    [ 7, 0, 0, 0, 0, 0, 0, 0, 0, 4 ],
    [ 7, 0, 0, 0, 0, 0, 0, 0, 0, 4 ],
    [ 7, 0, 0, 0, 0, 0, 0, 0, 0, 4 ],
    [ 7, 0, 0, 0, 0, 0, 0, 0, 0, 4 ],
    [ 6, 6, 6, 6, 6, 0, 5, 5, 5, 5 ]
  ],
  "MapFloor": [
    [ 1, 1, 1, 1, 1, 1, 1, 1, 1, 1 ],
    [ 1, 1, 1, 1, 1, 1, 1, 1, 1, 1 ],
    [ 1, 1, 1, 1, 1, 1, 1, 1, 1, 1 ],
    [ 1, 1, 1, 1, 1, 1, 1, 1, 1, 1 ],
    [ 1, 1, 1, 1, 1, 1, 1, 1, 1, 1 ],
    [ 1, 1, 1, 1, 1, 1, 1, 1, 1, 1 ],
    [ 1, 1, 1, 1, 1, 1, 1, 1, 1, 1 ],
    [ 1, 1, 1, 1, 1, 1, 1, 1, 1, 1 ],
    [ 1, 1, 1, 1, 1, 1, 1, 1, 1, 1 ],
    [ 1, 1, 1, 1, 1, 1, 1, 1, 1, 1 ]
  ],
  "Sprites": [
    {
      "Type": 0,
      "Id": 2,
      "Position": {
        "X": 1,
        "Y": 1
      }
    },
    {
      "Type": 1,
      "Id": 3,
      "Position": {
        "X": 2,
        "Y": 1
      }
    },
    {
      "Type": 2,
      "Id": 1,
      "Position": {
        "X": 3,
        "Y": 1
      }
    }
  ]
}